0,0,0,0,0,0,7,7,0,0,0,0,0,0
0,0,0,0,0,6,7,7,6,0,0,0,0,0
0,0,0,0,5,6,7,7,6,5,0,0,0,0
0,0,0,4,5,6,7,7,6,5,4,0,0,0
0,0,3,4,5,6,7,7,6,5,4,3,0,0
0,2,3,4,5,6,7,7,6,5,4,3,2,0
0,0,3,4,5,6,7,7,6,5,4,3,0,0
0,0,0,4,5,6,7,7,6,5,4,0,0,0
0,0,0,0,5,6,7,7,6,5,0,0,0,0
0,0,0,0,0,6,7,7,6,0,0,0,0,0
0,0,0,0,0,0,7,7,0,0,0,0,0,0