BL,BL,BL,BL,BL,BL,BL,BL,BL,BL,BL,BL,BL,BL
GR,GR,GR,GR,GR,GR,00,GR,GR,GR,GR,GR,GR,GR
OR,OR,OR,OR,OR,OR,00,OR,OR,OR,OR,OR,OR,OR
PU,PU,PU,PU,PU,PU,00,PU,PU,PU,PU,PU,PU,PU
PI,PI,PI,PI,PI,PI,00,PI,PI,PI,PI,PI,PI,PI
YE,YE,YE,YE,YE,YE,00,00,00,YE,YE,YE,YE,YE
RE,RE,RE,RE,RE,RE,RE,RE,RE,RE,RE,RE,RE,RE