1,3,3,0,0,0,0,0,0,0,0,3,3,1
2,3,0,0,0,0,0,0,0,0,0,0,3,2
3,0,0,0,3,0,0,0,3,3,0,0,0,3
4,0,0,0,3,0,0,3,0,0,0,0,0,4
5,0,0,0,3,0,3,0,0,0,0,0,0,5
6,0,0,0,3,3,0,0,0,0,0,0,0,6
7,0,0,0,3,0,3,0,0,0,0,0,0,7
1,0,0,0,3,0,0,3,0,0,0,0,0,1
2,3,0,0,3,0,0,0,3,3,0,0,3,2
8,9,10,0,0,0,14,14,0,0,0,8,9,10