8,0,0,0,0,0,0,7,7,0,0,0,0,8
8,0,0,0,0,0,0,7,7,0,0,0,0,8
8,0,0,0,0,0,0,7,7,0,0,0,0,8
8,0,0,0,0,0,0,7,7,0,0,0,0,8
8,0,0,0,0,0,0,7,7,0,0,0,0,8
8,0,0,0,0,0,0,7,7,0,0,0,0,8
8,0,0,0,0,7,0,7,7,0,0,0,0,8
8,0,0,0,0,7,0,7,7,0,0,0,0,8
8,0,0,0,0,7,6,6,7,0,0,0,0,8
8,0,0,0,0,7,7,7,7,0,0,0,0,8