BL,BL,BL,BL,BL,BL,BL,BL,BL,BL,BL,BL,BL,BL
GR,GR,GR,GR,GR,GR,GR,GR,GR,GR,GR,GR,GR,GR
OR,OR,OR,OR,OR,OR,OR,OR,OR,OR,OR,OR,OR,OR
PI,PI,PI,PI,PI,PI,PI,PI,PI,PI,PI,PI,PI,PI
PU,PU,PU,PU,PU,PU,PU,PU,PU,PU,PU,PU,PU,PU
RE,RE,RE,RE,RE,RE,RE,RE,RE,RE,RE,RE,RE,RE
YE,YE,YE,YE,YE,YE,YE,YE,YE,YE,YE,YE,YE,YE